######
#*  *#
#    #
#.$$$#
######
