######
#. $@#
#    #
#. $ #
######
