 #####
##.@ #
# $$ #
#.  ##
#####
