######
#.$  #
#+$  #
#. $ #
#  ###
####