######
#  . #
# $ .#
##$$ #
#.@ ##
#####