   #####
####   #
#  $@$ #
# .  .##
#######