#####
#.  ##
#@.$ #
# $  #
###  #
  ####