#######
#  $..#
#   $@#
#  $.##
######