######
#. $+#
##$ .#
#  $ #
#   ##
#####