  ####
###  #
# $  #
# .$@#
# .$.#
######