 #####
##@ .#
#.$ .#
#$ $ #
#   ##
#####