 #####
 #@ .#
##$$*#
#  . #
#    #
######