#####
# .@# 
# .$##
# $  #
##   #
 #####
