#####
#   ##
#$ *@#
#..$ #
######