########
# $  . #
#@$ # .#
# $$ . #
#  #  .#
########