########
#.     #
#. #$  #
#.*$@$ #
#.  $ ##
#######