 ####
##  ####
#@$    #
#  **. #
# $  . #
########