#######
# .  @#
#$$$. #
#.  # #
#  $. #
#######