#####
#. .####
#@.$$  #
## $   #
 ###   #
   #####