########
#.#. $ #
# . #  #
#  $$$@#
#..  $ #
########