    ####
#####  #
# $ $  #
#.  $$ #
#... @##
#######