########
#..#   #
#   $$ #
#. $#@ #
# .  $ #
########