  ####
###  ###
# $. $ #
#..*$$ #
# @.   #
########