  ######
###+$  #
#.#$$  #
# . $  #
#..  $ #
########