#####
# . ##
#  $ ##
##  $+#
 ######
