  #####
###   #
# $   #
#.@$.##
######