 #####
 #   #
##   #
# $*##
# @ .#
######