#####
#  .##
#  $@#
##$  #
 # . #
 #####