#####
#   ##
#   @#
##$$ #
#. .##
#####