######
#.   ###
# $ $  #
# .#@  #
########